./assets/Full.png
x,x x,x x,x x,x x,x x,x
x,x x,x x,x x,x x,x x,x
0,0 1,0 2,0 3,0 4,0 5,0
0,1 1,1 2,1 3,1 4,1 5,1
0,2 1,2 1,2 1,2 1,2 5,2
0,2 1,2 1,2 1,2 1,2 5,2
0,2 1,2 1,2 1,2 1,2 5,2
0,2 1,2 1,2 1,2 1,2 5,2
0,2 1,2 1,2 1,2 1,2 5,2
0,2 1,2 1,2 1,2 1,2 5,2
0,2 1,2 1,2 1,2 1,2 5,2
0,4 1,4 2,4 3,4 4,4 5,4